###################
o               T #
#    ##############
#    #  !       $ #
#    #      #   $ #
#    # $$$$ #   $ _
#!!###      #     #
#           #     #
#           #   $ #
###################
