##########
#     ## #
o     #  _
#     #  #
#     #  #
#  ! $$$ #
##########
