##########
o       !#
#   $    #
#   $    #
#        _
##########
