##########
#        #
o   T    _
#  ####  #
#  #$$#! #
#  #  #  #
#  ####  #
##########
