###################
o    #          $ #
#    #          $ #
#    #  !       $ #
#    #      #   $ #
#    #      #     _
#    #      #     #
#        ####     #
#    $$$$   #     #
###################
