##########
         #
#   $    #
#   $    #
#        #
##########
